1111111
11000L1
111EP11
1C00001
1111111