111111
111P11
111111
100CE1
111111