111111
1C10C1
111101
100001
1E00P1
111111