11111111
1E000C01
1E111P01
11111111
