1111111111111111111111111111
111111111111111111000000C011
11111C0000110000101010001001
1P11110000000000111100010011
1001100111100001111100000111
11000000000000000000000C1111
11110000E0001110000110000111
1111100000000000000000011111
1111111100000000011000000C01
1111111111111111111111111111
