1111111111
10000000E1
1111C00011
1111P11111
111111111
