1111111
111P111
1CE0011
1111111