1111111111111
1000CC0111111
1011C10000111
1P011111100E1
1111111111111
